BBBBBBBBBBBBBBBBBBBBBBBBBBBBBBBBB
WWWWWWWWWWWWWWWWWWWWWWWWWWWWWWWWW
WPBBBBBBBBBBBGBBWBBBBBBBBBBGBBBPW
WBWWWWWWBWWWWWWBWBWWWWWWBWWWWWWBW
WBBBBBBBBBBBBBBBBBBBBBBBBBBBBBBBW
WBWWWWWWBWBWWWWWWWWWWWBWBWWWWWWBW
WBBBBBBBBWBBBBBBWBBBBBBWBBBBBBBBW
WWWWWWWWBWWWWWWBWBWWWWWWBWWWWWWWW
BBBBBBBWBWBBBBBBBBBBBBBWBWBBBBBBB
WWWWWWWWBWBWWWBBBBBWWWBWBWWWWWWWW
WBBBBBBBBBBWBBBBBBBBBWBBBBBBBBBBW
WWWWWWWWBWBWBBBBGBBBBWBWBWWWWWWWW
WBBBBBBBBBBWBBBBBBBBBWBBBBBBBBBBW
WWWWWWWWBWBWWWWWWWWWWWBWBWWWWWWWW
BBBBBBBWBWBBBBBBBBBBBBBWBWBBBBBBB
WWWWWWWWBWWWWWWBWBWWWWWWBWWWWWWWW
WBBBBBBBBWBBBBBBWBBBBBBWBBBBBBBBW
WBWWWWWWBWBWWWWWWWWWWWBWBWWWWWWBW
WBBBBBBBBBBBBBBBHBBBBBBBBBBBBBBBW
WBWWWWWWBWWWWWWBWBWWWWWWBWWWWWWPW
WPBBBBBBBBBBBBBBWBBBBBBBBBBBBBBBW
WWWWWWWWWWWWWWWWWWWWWWWWWWWWWWWWW