WWWWWWWWWWWWWWWWWWWWWWWWWWWWWWWWW
WBBBBBBBBBBBBBBBWBBBBBBBBBBBBBBBW
WBWWWWWWBWWWWWWBWBWWWWWWBWWWWWWBW
WBBBBBBBBBBBBBBBBBBBBBBBBBBBBBBBW
WBWWWWWWBWBWWWWWWWWWWWBWBWWWWWWBW
WBBBBBBBBWBBBBBBWBBBBBBWBBBBBBBBW
WWWWWWWWBWWWWWWBWBWWWWWWBWWWWWWWW
BBBBBBBWBWBBBBBBBBBBBBBWBWBBBBBBB
WWWWWWWWBWBWWWBBBBBWWWBWBWWWWWWWW
WBBBBBBBBBBWBBBBBBBBBWBBBBBBBBBBW
WWWWWWWWBWBWBGBBGBBGBWBWBWWWWWWWW
WBBBBBBBBBBWBBBBBBBBBWBBBBBBBBBBW
WWWWWWWWBWBWWWWWWWWWWWBWBWWWWWWWW
BBBBBBBWBWBBBBBBBBBBBBBWBWBBBBBBB
WWWWWWWWBWWWWWWBWBWWWWWWBWWWWWWWW
WBBBBBBBBWBBBBBBWBBBBBBWBBBBBBBBW
WBWWWWWWBWBWWWWWWWWWWWBWBWWWWWWBW
WBBBBBBBBBBBBBBBHBBBBBBBBBBBBBBBW
WBWWWWWWBWWWWWWBWBWWWWWWBWWWWWWBW
WBBBBBBBBBBBBBBBWBBBBBBBBBBBBBBBW
WWWWWWWWWWWWWWWWWWWWWWWWWWWWWWWWW