WWWWWWWWWW
WBBBBHBBBW
WBBBBBBBBW
WBBBBBBBBW
WBBBBBBBBW
WBBBBBBBBW
WBBBBBBBBW
WBBBBBBBBW
WBBBBBBBBW
WWWWWWWWWW
WWWWWWWWWW
WWWWWWWWWW