----------------------------
----------------------------
############################
#............##............#
#.####.#####.##.#####.####.#
#.####.#####.##.#####.####.#
#.####.#####.##.#####.####.#
#..........................#
#.####.##.########.##.####.#
#.####.##.########.##.####.#
#......##....##....##......#
######.#####.##.#####.######
-----#.#####-##-#####.#-----
-----#.##----------##.#-----
-----#.##-##----##-##.#-----
######.##-#------#-##.######
------.---#-G----#---.------
######.##-#------#-##.######
-----#.##-########-##.#-----
-----#.##----------##.#-----
-----#.##-########-##.#-----
######.##-########-##.######
#............##............#
#.####.#####.##.#####.####.#
#.####.#####.##.#####.####.#
#...##.......P........##...#
###.##.##.########.##.##.###
###.##.##.########.##.##.###
#......##....##....##......#
#.##########.##.##########.#
#.##########.##.##########.#
#..........................#
############################