WWWWWWWWWW
WBBBBHBBBW
WBBBBBBBBW
WBBBBBBBBW
WBBGBBBBBW
WBBBBPPBBW
WBBBWWWBBW
WBBBBBBBBW
WBBBBBBBBW
WWWWWWWWWW
WWWWWWWWWW
WWWWWWWWWW